wwwwwwwwwwwwwwwwwwww
w                  w
w    P   wwwwwwwwwww
w                  w
w                  w
wwwwwwwwwwww       w
w                  w
w         eee      w
w                  w
wwwwwwwwwww        w
w         e        w
w                  w
w   e    wwwwwwwwwww
w                  w
wwwwwwwwwwwwwwwwwwww